{
    "f10":  140,
    "a36":  27,
    "a3":  3,
    "b30":  57,
    "b1":  35,
    "a38":  29,
    "b34":  61,
    "b2":  36,
    "f7":  137,
    "c6":  94,
    "b44":  69,
    "a22":  17,
    "b61":  83,
    "d4":  108,
    "a24":  18,
    "d8":  112,
    "b41":  67,
    "b12":  44,
    "b49":  73,
    "b9":  41,
    "d6":  110,
    "b18":  50,
    "a46":  33,
    "d9":  113,
    "b65":  89,
    "b51":  74,
    "a20":  16,
    "b16":  48,
    "b24":  53,
    "c40":  101,
    "a9":  7,
    "d1":  105,
    "d16":  119,
    "d14":  117,
    "a32":  23,
    "a7":  5,
    "c29":  98,
    "a37":  28,
    "a2":  2,
    "a34":  25,
    "a39":  30,
    "b37":  64,
    "b3":  37,
    "d12":  115,
    "f9":  139,
    "b59":  81,
    "b55":  78,
    "b52":  75,
    "c6أ":  95,
    "f3":  136,
    "c1":  91,
    "b60":  82,
    "b11":  43,
    "b21":  52,
    "b6":  38,
    "a40":  31,
    "a15":  12,
    "c38":  99,
    "d17":  120,
    "b28":  55,
    "b15":  47,
    "b33":  60,
    "b25":  54,
    "b63أ":  86,
    "f2":  135,
    "c28":  97,
    "a33":  24,
    "b38":  65,
    "b66":  90,
    "d10":  114,
    "a35":  26,
    "c5":  93,
    "b57":  79,
    "d13":  116,
    "c45":  103,
    "d3":  107,
    "b58":  80,
    "b63ب":  87,
    "c44":  102,
    "a29":  21,
    "c4":  92,
    "b39":  66,
    "d5":  109,
    "a11":  9,
    "d21":  123,
    "d7":  111,
    "a12":  10,
    "b7":  39,
    "a43":  32,
    "a17":  13,
    "b10":  42,
    "a8":  6,
    "a18":  14,
    "b14":  46,
    "b32":  59,
    "b43":  68,
    "b17":  49,
    "b31":  58,
    "b47":  71,
    "a1":  1,
    "a10":  8,
    "f1":  134,
    "b36":  63,
    "b48":  72,
    "b35":  62,
    "c7":  96,
    "c46":  104,
    "d2":  106,
    "b46":  70,
    "b64":  88,
    "a25":  19,
    "b53":  76,
    "a28":  20,
    "b63":  85,
    "b13":  45,
    "f8":  138,
    "b8":  40,
    "a30":  22,
    "c39":  100,
    "b62":  84,
    "b29":  56,
    "d20":  122,
    "d18":  121,
    "a14":  11,
    "d15":  118,
    "a19":  15,
    "b54":  77,
    "b20":  51,
    "a5":  4
}